UbberFrame	KEYWORD1

frameFromChar	KEYWORD1
frameToChar	KEYWORD1

setType	KEYWORD1
setDestID	KEYWORD1
setSourceID	KEYWORD1
setFlags	KEYWORD1
setPayload	KEYWORD1

getType	KEYWORD1
getDestID	KEYWORD1
getSourceID	KEYWORD1
getFlags	KEYWORD1
getPayloadSize	KEYWORD1
getPayload	KEYWORD1
getLength	KEYWORD1
iDString	KEYWORD1
typeString	KEYWORD1
getTypeString	KEYWORD1
getSourceIDString	KEYWORD1
getDestIDString	KEYWORK1

PAYLOAD_DEFINED	LITERAL1
PAUSE	LITERAL1
RENCONTRE	LITERAL1
REPAS	LITERAL1
CLOPE	LITERAL1
CAFE	LITERAL1
PISCINE	LITERAL1
EPICURIA	LITERAL1
VELO	LITERAL1
MAJ	LITERAL1
ACQUITTEMENT	LITERAL1

BEN_M	LITERAL1
CLEMENT	LITERAL1
JEJE	LITERAL1
MARC	LITERAL1
GUILLAUME_S	LITERAL1
DAMS	LITERAL1
GUILLAUME_L	LITERAL1
ALL	LITERAL1

